11111111111111111111111
1N00N0000N00N00N00N00N1
1N00N0000N00N00N00N00N1
1N00N0000N00N00N00N00N1
1N00N0000N00N00N00N00N1
1N00N0000N00N00N00N00N1
10111011101110111011101
1PC00C00C00C00C00C00C01
1E111111111111111111111
11111111111111111111111